#########,
#....*.*#,
#.....#.#,
#..o...*#,
#.o.o...#,
#..@....#,
#.......#,
#.......#,
#########,