######,
#..###,
#.oo.#,
#***.#,
#.@o.#,
#...##,
######,