##########,
###.....##,
###......#,
####.....#,
##...#*..#,
#.o..o@.##,
#.#####*##,
#.......##,
##########,