##########,
#....#####,
#.ooo#####,
#..#**####,
##@.**o..#,
##.......#,
##########,