#############,
#...#####..*#,
#.o.o.###***#,
#.o...@..o.*#,
#.ooo...#..*#,
#...o...#..*#,
#...o#oo#***#,
#.......#..*#,
#############,