#########,
#....*..#,
#..o....#,
#..@....#,
#.......#,
#########,