#########,
##.....##,
#..**.o.#,
#..#o@.o#,
#....#.*#,
#########,