#########,
#.....###,
#..oo...#,
#..#*.*.#,
#..@....#,
#########,
