##############,
##...####....#,
#..o.####oo..#,
#...o****....#,
##..@..#.....#,
##############,